--------------------
-*       ?         -
--------------- --+-
-^+  ?   ^- ^ - -- -
---  -    - - - -- -
-    ---  - - - -- -
-  % -^+    - - -- -
---+--------- - -- -
-^               + -
------------------?-
-^       ?         -
---?----------------
-                +^-
-------+------------
-^ ?    -^  +   @  -
- ? ?   -^   ----  -
-     ? -   ^-     -
-  ------    -$$   -
-    ?       -$$$$$-
--------------------

